           The list of the abbreviations in the references.

-----------------------------------------------------------------------------------------------------------------------
Simb.|         GCVS              |         Literature
-----------------------------------------------------------------------------------------------------------------------
AcA  |AA                         |Acta Astronomica
AcASn|AA Sinica                  |Acta Astronomica Sinica
AcAS |AA Suppl                   |Acta Astronomica Supplementa
AAONw|AAO Newsletter             |Anglo-Australian Observatory Epping - Newsletter
AVSOA|AAVSO Abstr                |American Association of Variable Stars Observers - Abstracts
     |AAVSO Circr                |American Association of Variable Stars Observers - Circular
     |AAb                        |Acta Astronomica, Ser.b
     |AAc                        |Acta Astronomica, Ser.c
AnAp |AAp                        |Annales d'Astrophysique
MitAG|AG Mit                     |Mitteilungen der Astronomischen Gesellschaft, Hamburg
AJ   |AJ                         |The Astronomical Journal
AN   |AN                         |Astronomische Nachrichten
A&R  |AR                         |Astronomie und Raumfahrt
ASV  |ASV                        |Atlas stellarum variabilium.
MeAar|Aarhus Medd                |Meddelelser fra Ole Romer Observatoriet, Aarhus
AbaOB|Abastumani Byull           |Abastumanskaya Astrofizicheskaya Observatoriya, Gora Kanobili, Byulleten
     |Abh Deutsch Akad Wiss      |Abhandlungen der Deutschen Akademie der Wissenschaften. Mathemetische und naturwissenschaftliche Klasse
     |Abh Preuss Akad Wiss       |Abhandlungen der Preussischen Akademie der Wissenschaften. Mathemetische und naturwissenschaftliche Klasse
     |Acta Pontificia            |Acta Pontificia Academia Scientarium
PAllO|Allegheny Publ             |Publications of the Allegheny Observatory of the University of
ARA&A|Ann Rev As Ap              |Annual Review of Astronomy and Astrophysics
ApJ  |ApJ                        |The Astrophysical Journal
ApJS |ApJ Suppl                  |The Astrophysical Journal, Supplement Series
ApL  |ApL                        |Astrophysical Letters (continued by Astrophysical Letters &
Ap&SS|ApSS                       |Astrophysics and Space Science
     |Arcetri Pubbl              |Pubblicazioni dell'Universita degli Studi di Firenze. Osservazioni e Memorie dell' Osservatorio Astrofisico di Arcetri
BAAA |Argentina Bol              |Boletin de la Asociacion Argentina de Astronomia, La Plata, Argentina
TreP |Ariel Pubbl                |Osservatorio Privato Specola "Ariel" Treviso Italia - Pubblicazione
CoLPL|Arizona Comm               |Communications of the Lunar and Planetary Laboratory(Tucson)
ArA  |Ark Astr                   |Arkiv foer Astronomi
A&A  |AsAp                       |Astronomy and Astrophysics
A&AS |AsAp Suppl                 |Astronomy and Astrophysics, Supplement Series
CoAsi|Asiago Contr               |Contributi dell'Osservatorio Astrofisico dell'Universita di Padova in
     |Astr Abh Leipzig           |Astronomische Abhandlungen. Professor Dr.Cuno Hoffmeister zum 70. Geburtstage gewidmet, Leipzig
Afz  |Astrofizika                |Astrofizika, Erevan
ATsir|Astron Tsirk               |Astronomicheskij Tsirkulyar, Izdavaemyi Byuro Astronomicheskikh Soobshchenij Akademii Nauk SSSR
AZh  |Astron Zh                  |Astronomicheskij Zhurnal (translation in Astronomy Reports)
PAZh |Astron Zh Pisma            |Pis'ma v Astronomicheskij Zhurnal
BAth |Athens Bull                |National Observatory of Athens, Greece - Bulletin of the Astronomical
AtlVS|Atlas of Finding Charts ...|Atlas Poiskovykh Kart Peremennykh Zvezd
AuJPh|Austral J Phys             |Australian Journal of Physics
AuJPA|Austral J Phys Ap Supp     |Australian Journal of Physics, Astrophysical Supplement
     |BA                         |Bulletin Astronomique.
BAORB|BA Uccle                   |Bulletin Astronomique. Observatoire Royal de Belgique (Astronomisch Bulletin. Koninklijke Sterrenwacht van Belgie)
BAAS |BAAS                       |Bulletin of the American Astronomical Society
BAICz|BAC                        |Bulletin of the Astronomical Institutes of Czechoslovakia, Praha
     |BAF                        |Bulletin de l'Association Francaise d'Observateurs d'Etoiles Variables, Lyon (1932-1954)
AFOEV|BAFOEV                     |Bulletin de l'Association Francaise d'Observateurs d'Etoiles Variables (since 1970)
BAN  |BAN                        |Bulletin of the Astronomical Institutes of the Netherlands
BANS |BAN Suppl                  |Bulletin of the Astronomical Institutes of the Netherlands, Supplement
BAVSR|BAV-R                      |BAV Rundbrief - Mitteilungsblatt der Berliner Arbeits-gemeinschaft fuer Veraenderliche Sterne
BBSAG|BBSAG Bull                 |Bulletin der Bedeckungsveraenderlichen-Beobachter der Schweizerischen
     |BSAF                       |Bulletin de la Societe Astronomique de France (l'Astronomie)
BMai |BSAM                       |Bulletin de la Station Astrophotographique de Mainterne
     |BSD                        |Bergdorfer Spektral-Durchmusterung.
ANZi |BZ                         |Beobachtungs-Zirkular der Astronomischen Nachrichten
BamVe|Bamb Ver                   |Bamberg Veroeffentlichungen der Remeis-Sternwarte
     |Belg Ann                   |Annales de l'Observatoire Royal de Belgique (nouvelle serie). Annales Astronomiques
BOBeo|Belgrad Bull               |Bulletin de l'Observatoire Astronomique de Belgrade (ISSN: 0354-2955)
AAHam|Bergd Abh                  |Astronomische Abhandlungen der Hamburger Sternwarte
     |Bol Mim Ton y Tak          |Boletin Mimeografico de los Observatorios Tonantzintla y Tacubaya
POBol|Bologna Pubbl              |Pubblicazioni dell'Osservatorio Astronomico Universitario  di Bologna
VeBon|Bonn Veroeff               |Veroeffentlichungen der Universitaets-Sternwarte zu Bonn (Astronomischen
CoBos|Bosscha Contr              |Contributions from the Bosscha Observatory
CoBrn|Brno Obs and Plan Cont     |Contributions of the Public Observatory and Planetarium in Brno
     |Brno Univ Contr            |Astronomical Institute of the Brno University. Contributions
MiBud|Bud Mitt                   |Mitteilungen der Sternwarte der Ungarischen Akademie der Wissenschaften,     |                 | Budapest (Budapest - Szabadsaghegy)(continued by CoKon after 1980)
     |Bul Stiint                 |Buletin Stiinfic (Academia Republici populare Romane)
     |Bull Acad Petersb          |Bulletin de l'Academie Imperiale des Sciences de St-Petersbourg
BAICz|Bull Astr Inst Czech       |Bulletin of the Astronomical Institutes of Czechoslovakia
     |CR                         |Comptes Rendus Hebdomadaires des Seances de l'Academie des Sciences.
C&T  |CT                         |Ciel et Terre
     |Cambridge Report           |University of Cambridge. Report of the Observatories Syndicate
AnCap|Cape Ann                   |Annals of the Cape Observatory
     |Cape Mim                   |Royal Observatory, Cape of Good Hope, Cape Mimeogram
     |Cape Report                |Report of Her Majesty Astronomer at the Cape of Good Hope to the Secretary of the Admiralty
NapCo|Capodimonte Contr          |Osservatorio Astronomico di Capodimonte-Napoli - Contributi Astronomici
PCat |Catania Publ               |Osservatorio Astrofisico di Catania, Pubblicazioni, Nuova Serie
POAN |Cerro Calan Publ           |Departamento de Astronomia, Universidad de Chile, Observatorio Astronomico Nacional, Cerro Calan Publicaciones
CoTol|Cerro Tololo Contr         |Contributions from the Cerro Tololo Inter-American Observatory
POClu|Cluj Publ                  |Publicatiile Observatorului Astronomical Universitatii din Cluj
Coel |Coelum                     |Coelum - Periodico Bimestrale per la Divulgazione dell'Astronomia
     |Commonwealth Mem           |Memoirs of the Commonwealth  Observatory, Mount Stromlo,Canberra
RNAO |Cord Res                   |Resultados del Observatorio Nacional Argentino
CoDDO|DDO Comm                   |Communications from the David Dunlap Observatory, Richmond Hill,
PDDO |DDO Publ                   |Publications of the David Dunlap Observatory
DOIAP|DOB                        |Documentation des Observateurs. Institut d'Astrophysique de Paris
DOCi |DOC                        |Documentation des Observateurs - Circulaire
AnDea|Dearborn Ann               |Annals of the Dearborn Observatory of Northwestern University
EBCi |EBC                        |Eclipsing Binaries Circulars - Polska Akademia Nauk, Krakow
ESOAR|ESO Ann Rep                |European Southern Observatory - Annual Reports
     |ESO Repr                   |European Southern Observatory - Scientific Reprint
PROE |Edinburgh Publ             |Publications of the Royal Observatory, Edinburgh(suspended from vol 19
     |Enebo                      |Beobachtungen veraenderlicher Sterne angestellt auf Dombas (Norwegen) von Sigurd Einbus (Enebo)
KazOB|Engel'gardt Byull          |Astronomicheskoj Observatorii im V.P. Engel'gardta, Kazan - Byulleten'
ANErg|Erg AN                     |Ergaenzungshefte zu den Astronomischen Nachrichten
CoFra|Frascati Contr             |Consiglio Nazionale delle Ricerche (Italia). Laboratorio di Astrofisica, Frascati (Roma), Contributi
     |Frascati Rapp              |Laboratorio di Astrofisica (universita di Roma). 4a sezone del centro di astrofisica (CNR). Frascati, Roma.Rapporto Interno
GCVS3|GCVS                       |General Catalogue of Variable Stars. Ed.: B.V. Kukarkin et al. Sternberg State Astronomical Institut. Publ.: Astronomical Council of the Academy of Sciences in the USSR, Moscow, 1948 (1st ed.), 1958 (2nd ed.), 1969-1971 (3rd ed.).
GCVS4|GCVS                       |Combined General Catalogue of Variable Stars (1998), 4.1 Ed (II/214A). Kholopov P.N. et al.
     |GCVS Suppl I-IX            |I-IX Supplements to the editions of the General Catalogue of Variables Stars. Ed.: B.V. Kukarkin et al., Moscow.
GEOSN|GEOS NC                    |GEOS Note Circulaire - Group: Etude et Observation Stellaire, Paris
     |GEOS SR                    |GEOS Circulare on Red Variable Stars - Group: Etude et Observation Stellaire, Paris
     |GOEV                       |Groupment des Observateurs d'Etoiles Variables
GSC1 |GSC                        |The HST Guide Star Catalog Version 1.1 (I/220)
PGen |Geneve Publ                |Publications de l'Observatoire de Geneve
ANote|Goeteborg Astr Notes       |Astronomical Notes - University of Gothenburg, Sweden, Section of
PGLO |Goethe Link Publ           |Publications of the Goethe Link Observatory of Indiana University, Bloomington, Indiana
PGooO|Goodsell Publ              |Publications of the Goodsell Observatory of Carlton College, Northfield, Minnesota
GUL  |Gul                        |Geschichte und Lichtwechsel der Veraenderlichen Sterne (Potsdam)
AnHar|HA                         |Annals of Harvard College Observatory
HarAC|HAC                        |Harvard College Observatory. Announcement Card
BHarO|HB                         |Bulletin of the Harvard College Observatory
HarCi|HC                         |Harvard College Observatory Circular
AVSOQ|HQR                        |American Association of Variable Stars Observers - Quarterly Reports, Harvard
HalAR|Hale Obs Rep               |Hale Observatories, Pasadena, California - Annual Report of the Director
MiHam|Hamb/Berg Mitt             |Mitteilungen der Hamburger Sternwarte in Bergedorf
HarZi|Hartha BZ                  |Harthaer Beobachtungs-Zirkular
MiHar|Hartha Mitt                |Mitteilungen der Bruno-H.-Buergel-Sternwarte, Hartha, DDR
HarRe|Harv Repr                  |Harvard College Observatory - Reprints
MiAR |Heidelberg Mitt            |Astronomisches Rechen-Institut Heidelberg, Mitteilungen
VeHei|Heidelberg Ver             |Veroeffentlichungen des Badischen Landessternwarte zu Heidelberg (Koenigstuhl)
MiHei|Heidelberg-Koenigstuhl Mitt|Mitt|Mitteilungen der Landessternwarte Heidelberg-Koenigstuhl
IAUC |IAU Cir                    |International Astronomical Union, Circular
IAUCo|IAU Coll                   |IAU Colloquia
IAUS |IAU Symp                   |IAU Symposia
IAUT |IAU Trans                  |Transactions of the International Astronomical Union
IBSH |IBSH                       |Information Bulletin for the Southern Hemisphere
IBVS |IBVS                       |Information Bulletin on Variable Stars
     |ICAR                       |Information Circular of the Astronomical Institutions in the USSR
IRC  |IRC                        |Two micron sky survey : A preliminary Catalogue. Calif. Inst.
IrAJ |Irish AJ                   |Irish Astronomical Journal
     |Izv AN Kaz SSR             |Izvestiya Akademiya Nauk Kazakhskoj SSR, Alma-Ata, Ser. fiz. mat.
IzAlm|Izv Astrofiz Inst Alma-Ata |Izvestiya Astrofizicheskogo Instituta, Alma-Ata
IzKaz|Izv Astron Engel'gardt Obs |Izvestiya Astronomicheskoj Engel'gardt obskoj Observatorii, Kazan
IzKie|Izv Glav Astron Obs AN USSR|Izvestiya Glavnoj Astronomicheskoj Observatorii - Kiev, Akademiya Nauk
     |Izv Krymsk Astrofiz Obs    |Izvestiya Krymskoj Astronomicheskoj Observatorii
AISAO|Izv SAO                    |Astrofizicheskie Issledovaniya. Izvestiya Spetsial'noj Astrofizicheskoj
JAVSO|JAAVSO                     |Journal of the American Association of Variable Stars Observers
JASAC|JASAC                      |Japan Astronomical Study Association - Circulars
JApA |JApAs                      |Journal of Astrophysics and Astronomy
JBAA |JBAA                       |Journal of the British Astronomical Association
JO   |JO                         |Journal des Observateurs
JRASC|JRASCan                    |Journal of the Royal Astronomical Society of Canada
JBAn |Jodrell Bank Ann           |Astronomical Contributions from the University of Manchester - Jodrell Bank Annals
     |KE                         |Katalog und Ephemeriden veraenderlicher Sterne
BamKV|KVB                        |Bamberg Kleine Veroeffentlichungen der Remeis-Sternwarte
KVeBB|KVBB                       |Kleine Veroeffentlichungen der Universitaetssternwarte zu Berlin-
GroR |Kapteyn Report             |Kapteyn Astronomical Laboratory, Groningen, Nederlandse Vereniging voor Weer - en Sterrenkunde - Reports
CoKit|Kitt Peak Contr            |Contributions from the Kitt Peak National Observatory
PCopO|Kobenhavn Publ             |Publikationer og mindre Meddelelser fra Kobenhavns Observatorium
VeHei|Koenigstuhl Ver            |Veroeffentlichungen der Heidelberg-Koenigstuhl Sternwarte
CraR |Krak Astr Rep              |Polskie Towarzyslwo Milosnikow Astronomii (Polskie Amateur Astronomical Society), Krakow - The Astronomical Reports
CraRe|Krak Circ                  |Cracow Observatory - Circular
     |Kyoto Bull                 |Bulletin published by the Kwasan Observatory, Imperial University of Kyoto
BAAA |La Plata Bol               |Boletin de la Asociacion Argentina de Astronomia, La Plata, Argentina
AnLei|Leid Ann                   |Annalen van de Sterrewacht te Leiden
AnBos|Lemb Ann                   |Annals of the Bosscha Observatory Lembang (Java) Indonesia
LicOB|Lick Bull                  |Lick Observatory Bulletin
CoLic|Lick Contr                 |Contributions from the Lick Observatory
PLicO|Lick Publ                  |Publications of the Lick Observatory
ULIA4|Liege Coll in 4            |Universite de Liege, Institut d'Astrophysique, Liege - Collection in 4
MSRSL|Liege Mem / Mem Liege      |Memoires de la Societe Royale des Sciences de Liege
ULIA8|Liege Mem / Mem Liege      |Universite de Liege, Institut d'Astrophysique, Liege - Collection in 8
PIAG |Louvain Publ               |Publications de l'Institut d'Astronomie et de Geophysique, Louvain
LowOB|Lowell Bull                |Lowell Observatory Bulletin
MeLu1|Lund Medd                  |Meddelanden fran Lunds Astronomiska Observatorium, Serie I
MeLu2|Lund Medd                  |Meddelanden fran Lunds Astronomiska Observatorium, Serie II
     |Lwow Contr                 |Contributions from the Astronomical Instituite of Lwow University
     |Lyon Bull                  |Bulletin de l'Observatoire de Lyon
POLyo|Lyon Publ                  |Publication de l'Observatoire de Lyon
MNRAS|MN                         |Monthly Notices of the Royal Astronomical Society
MNSSA|MN ASSA                    |Monthly Notes of the Astronomical Society of Southern Africa
     |MS                         |Manuscript
MitVS|MVS                        |Zentralinstitut fuer Astrophysik, Sternwarte Sonneberg - Mitteilungen ueber Veraenderliche Sterne
MitVS|MVS Suppl                  |Zentralinstitut fuer Astrophysik, Sternwarte Sonneberg - Mitteilungen ueber Veraenderliche Sterne, Supplement
CoMcD|Mc Donald Contr            |Contributions from the McDonald Observatory - The University of Texas,
PMcCO|McCormick Publ             |Publications of the Leander Mc Cormik Observatory of the University of Virginia, Charlottesville
MeGen|Medd Univ Gent             |Mededelingen - Universiteit te Gent, Sterrenkundig Instituut
MmRAS|Mem RAS                    |Memoirs of the Royal Astronomical Society
MmSAI|Mem SAIt                   |Memorie della Societa Astronomica Italiana
POMic|Michigan Publ              |Publications of the Observatory of the University of Michigan, Ann Arbor, Mich
MicRe|Michigan Repr              |Reprints from the Observatory of the University of Michigan, Ann Arbor
CoMil|Milano-Merate Contr        |Contributi dell'Osservatorio Astronomico di Milano-Merate. Nuova Series
POMin|Minn Publ                  |Publications of the Astronomical Observatory. University of Minnesota
     |Mirovedenie Astr Bull      |Astronomicheskii Byulleten Russ. Obshchestva Lyubitelej Mirovedeniya.
     |Mosc Ann                   |Annales de l'Observatoire Astronomique de Moscou
MmMtS|Mt Stromlo Mem             |Memoirs of the Mount Stromlo Observatory
MtSOM|Mt Stromlo Mim             |Mount Stromlo Observatory Mimeogram
NATi |NAT                        |Nordisk Astronomisk Tidsskrift
GCVS1|NSV                        |Catalogue of suspected variable stars. Ed.: B.V. Kukarkin et al. Sternberg State Astronomical Institut and Astronomical Council of the Academy of Sciences in the USSR, Moscow, 1982
VSSCi|NZ Circ                    |Royal Astronomical Society of New Zealand, Variable Star Section - Circulars
     |NZAS Obs                   |Royal Astronomical Society of New Zealand, Variable Star Section - Observations
PVSS |NZAS Publ                  |Royal Astronomical Society of New Zealand - Publications of Variable Star Section
NPhS |Nature Phys Sci            |Nature, Physical Science
NInfo|Nauchn Inform              |Nauchnye Informatsii, Astronomical Council of the Academy of Sciences in the USSR, Moscow
PUSNO|Naval Obs Publ             |Publications of the United States Naval Observatory (Second Series)
NAZ  |Nbl AZ                     |Nachrichtenblatt der Astronomischen Zentralstelle, Heidelberg
     |OAA Rep                    |Report of the Variable Stars Section of the Oriental Astronomical Association
Obs  |Obs                        |The Observatory
     |Odessa Astr Publ           |Odesskij Gosudarstvennyi Universitet im. I. I. Mechnikova - Astronomical Publications Astronomicheskoj Observatorii
BOOde|Odessa Byull               |Odesskij Gosudarstvennyi Universitet im. I. I. Mechnikova - Byulletin' Astronomicheskoj Observatorii
IzOde|Odessa Izv                 |Odesskij Gosudarstvennyi Universitet im. I. I. Mechnikova - Izvestiya Astronomicheskoj Observatorii
PDO  |Ottawa Publ                |Publications of the Dominion Observatory, Ottawa, Ontario, Canada
PA   |PA                         |Popular Astronomy. Northfield, Minn., U.S.A.
PAAS |PAAS                       |Publications of the American Astronomical Society
PASJ |PAS Japan                  |Publications of the Astronomical Society of Japan
PASP |PASP                       |Publications of the Astronomical Society of the Pacific
PMMin|PMS 48"                    |Proper Motion Survey with the 48-inch Telescope, $ fasc. 1-57,$ 1963-81,
PNAS |PNAS                       |Proceedings of the National Academy of Sciences of the United States of America
PadCR|Padova Com                 |Osservatorio Astronomico di Padova - Comunicazioni e Rassegne
POPad|Padova Publ                |Pubblicazioni dell'Osservatorio Astronomico di Padova
     |Peking Repr                |Peking Astronomical Observatory - Reprints
PF&CO|Penn Publ                  |Publications of the University of Pennsylvania, Astronomical Series, Flower and Cook Astronomical Observatory
PZ   |Perem Zvezdy               |Peremennye Zvezdy (variable stars)
PZP  |Perem Zvezdy Prilozhenie   |Peremennye Zvezdy, Prilozhenie(Variable Stars, Supplement)
CoPer|Perkins Contr              |Ohio State and Wesleyan Universities - Contributions from the Perkins Observatory, Delaware, Ohio
PoA  |Postepy Astr               |Postepy Astronomii, Krakow
POPot|Potsd Publ                 |Publikationen des Astrophysikalischen Observatoriums zu Potsdam
MiPot|Potsdam Mitt               |Mitteilungen des Astrophysikalischen Observatoriums, Potsdam
     |Princ Contr                |Contributions from the Princeton University Observatory
PASAu|Proc ASA                   |Proceedings of the Astronomical Society of Australia (continued by PASA)
     |Proc Roy Irish Acad        |Proceedings of the Royal Irish Academy
IzPul|Pulkovo Izv                |Izvestiya Glavnoj Astronomicheskoj Observatorii v Pulkove
TsPul|Pulkovo Tsirk              |Tsirkulyary Glavnoj Astronomicheskoj Observatorii i Pulkove
QJRAS|QJRAS                      |Quarterly Journal of the Royal Astronomical Society (continue with A&G from no 38 - 1997)
ROAn |ROA                        |Royal Observatory Annals
     |ROB                        |Royal Observatory, Bulletins
RMxAA|Rev Mex                    |Revista Mexicana de Astronomia y Astrofisica
RA   |Ric Astr                   |Specola Astronomica Vaticana - Richerche Astronomiche
     |Riv Publ                   |Riverview College Observatory Publications
     |Riv Repr                   |Riverview College Observatory Reprints
RosOB|Rosario Bol                |Observatorio Astronomico Municipal de Rosario, Argentia - Boletin
     |Rostov Byull               |Byulleten' Rostovskoj Astronomicheskoj Observatorii - Rostovskogo Gos. Universiteta -
CoRut|Rutherfurd Contr           |Contributions from the Rutherford Observatory of Columbia University, New York
SAAOC|SAAO Circ                  |South African Astronomical Observatory, Circulars
Roczn|SAC                        |Rocznik Astronomiczny Observatorjum Krakowskiego. Supplemento Internationale
SAOSR|SAO Special Report         |Smithsonian Institution. Astrophysical Observatory. Research in Space Science. SAO Special Report
LB   |SFBS                       |A search for faint blue stars [LB]. The Observatory, Univ. Minnesota, Minneapolis
SoShe|Shemakha Soobshch          |Soobshchenie Shemakhinskoj Astrofizicheskoj Observatorii - Akademiya Nauk Azerbajdzhanskoj SSR
     |Sitzb Akad Berlin          |Sitzungberichte der preussischen  Akad. der Wissenschaften phys, -math. Klasse, Berlin
     |Sitzb Akad Wien            |Sitzungberichte der Eosterreichischen  Akad. der Wissenschaften in Wien, math.-naturwissenschaftliche Klasse, Wien
CoSka|Skalnate Pleso Contr       |Contributions of the Astronomical Observatory Skalnate Pleso
S&T  |Sky and Tel                |Sky and Telescope
SAOCo|Smith Contr                |Smithsonian Astrophysical Observatory, Cambridge, Massachusetts - Smithsonian Contributions to Astrophysics
MiSon|Sonn Mitt                  |Mitteilungen der Sternwarte zu Sonneberg
SoSht|Soobshch  GAI Sternberg    |Soobshcheniya Gosudarstvennogo Astronomicheskogo Instituta im. P.K. Sternberga
SoByu|Soobshch Byurakan Obs      |Soobshcheniya Byurakanskoj Observatorii - Akademiya Nauk Armyanskoj SSR, Erevan
     |Soobshch Gruz AN SSR       |Soobshcheniya   Akademii Nauk Gruzinskoj SSR
SoSAO|Soobshch SAO               |Soobshcheniya Spetsial'noj Astrofizicheskoj Observatorii
SvA  |Soviet Astronomy           |Soviet Astronomy (English translation of "Astronomicheskij Zhurnal",
VatOP|Spec Vat                   |Vatican Observatory Publications
     |Spraw Polsk Tow Astr       |Sprawozdania Polskiega Towarzyslwa Astronomicznego
BStaO|Stalinabad Byull           |Byulleten' Stalinabadskoj Astronomicheskoj Observatorii - Akademiya Nauk Tadzhikskoj SSR -
TsSta|Stalinabad Tsirk           |Tsirkulyar Stalinabadskoj Astronomicheskoj Observatorii - Tadzhikskij Filial Akademii Nauk SSR
Stern|Sterne                     |Die Sterne
StoAn|Stockh Ann                 |Stockholms Observatoriums Annaler
StoMe|Stockh Medd                |Stockholms Observatoriums - Meddelande
SCA  |Stud Astr                  |Studii si Cercetari de Astronomie, Bucuresti
BOTT |TTB                        |Boletin de los Observatorios Tonantzintla y Tacubaya
BDus |Tadzh Byull                |Byulleten' Instituta Astrofiziki, Dushanbe - Akademiya Nauk Tadzhikskoj SSR
TrDus|Tadzh Tr                   |Trudy Instituta Astrofiziki, Dushanbe - Akademiya Nauk Tadzhikskoj SSR
     |Tadzh Tsirk                |Tsirkulyar Tadzhikskoj Astronomicheskoj Observatorii - Tadzhikskij Filial Akademii Nauk SSR
PTarO|Tartu Publ                 |Publikatsii Tartuskoj Astrofizicheskoj Observatorii im. V. Struve -
TarOT|Tartu Teated               |Tartu Astrofuusika Observatoorium Teated
     |Tashkent Bull              |Bulletin Tashkentskoj Astronomicheskoj Observatorii -  Akademiya Nauk
     |Telegr Byuro Astr Soobshch |Telegram, Byuro Astronom. Soobshchenii, Moskva
AnTok|Tokyo Ann                  |Annals of the Tokyo Astronomical Observatory
TokAB|Tokyo Bull                 |Tokyo Astronomical Bulletin
TokRe|Tokyo Repr                 |Tokyo Astronomical Observatory - Reprints
BITon|Ton Bol                    |Boletin del Instituto de Tonantzintla
CoTor|Torino Contr               |Contributi dell'Osservatorio Astronomico di Torino, Pino Torinese
BOTor|Torun Bull                 |Biuletyn Obserwatoium Astronomicznego Uniwersytetu M. Kopernika w Toruniu
AnTou|Toulouse Ann               |Annales de l'Observatoire Astronomique et Meteorologique de Toulouse
TrLen|Tr Astron Obs Leningrad    |Trudy Astronomicheskoj Observatorii. Leningrad
TrSht|Tr GAI Sternberg           |Trudy Gosudarstvennogo Astronomicheskogo Instituta im P.K.Sternberga
TrKaz|Tr Kazan Gorod Astron Obs  |Trudy Kazanskoj Gorodkoj Astronomicheskoj Observatorii
TrRig|Tr Radioastrofiz Obs Latv  |Trudy Radioastrofizicheskoj Observatorii, Riga -  Akademiya Nauk Latvijskoj
TrTas|Tr Tashkent Astron Obs     |Trudy Tashkentskoj Astronomicheskoj Observatorii -  Akademiya Nauk
     |Transv Circ                |Circular of the Transvaaal Observatory, Johannesburg
TriP |Trieste Publ               |Osservatorio Astronomico di Trieste - Pubblicazioni
TsTas|Tsirk Astron Inst Tashkent |Tsirkulyar Tashkentskoj Astronomicheskoj Observatorii -  Akademiya Nauk
LvoTs|Tsirk Astron Obs L'vov     |L'vovskij Ordena Lenina Gosudarstvennyj Universitet im. Ivana Franko - Tsirkulyar
TsShe|Tsirk Shemakh Astrofiz Obs |Tsirkulyar Shemakhinskoj Astrofizicheskoj Observatorii - Akademiya Nauk
UCLAP|UCLA Astron Papers         |Astronomical Papers - University of California, Los Angeles
CiUO |UOC                        |Circular of the Union Observatory, Johannesburg
     |Uch Zap L'vov Gos Univers  |L'vovskij Ordena Lenina Gosudarstvennyj Universitet im. Ivana Franko - Uchoenye Zapiski
UppAn|Uppsala Ann                |Uppsala Astronomiska Observatoriums Annaler
MeUpp|Uppsala Medd               |Meddelanden fran Astronomiska Observatorium Uppsala
UppOR|Uppsala Rep                |Uppsala Astronomical Observatory - Reports
Urani|Urania                     |Urania
UtrOv|Utrecht Overdruk           |Utrechtse Sterrekundige Overdrukken
     |Utrecht Rech               |Recherches Astronomiques de l'Observatoire d'Utrecht
VeBB |VBB                        |Veroeffentlichungen der Universitaetssternwarte zu Berlin-Babelsberg
VeSon|VSS                        |Veroeffentlichungen der Sternwarte in Sonneberg
     |Valk Ver                   |Veroeffentlichungen der Sternwarte des Ignatiuskollegs, Valkenburg
     |Versl Akad Amst            |Verslag van de gewone vergaderingen der wis- en natuurkundige afdeeling der Koninklijke Akademie van Wetenschappen te Amsterdam
     |Vestn Leningrad Univ       |Vestnik Leningradskogo Gos. Universiteta
CoDAO|Victoria Contr             |Contributions from the Dominion Astrophysical Observatory Victoria
PDAO |Victoria Publ              |Publications of the Dominion Astrophysical Observatory, Victoria, Canada
VilOB|Vilnius Bull               |Vilnius Astronomijos Observatorijos Biuletenis
PW&SO|Warner and Swasey Publ     |Publications of the Warner and Swasey Observatory
     |Wars Circ                  |Astronomical Observatory at Warsaw- Circular
     |Wars Publ                  |Astronomical Observatory of the Warsaw University - Publications
PWasO|Washb Publ                 |Publications of the Washburn Observatory of the University of Wisconsin, Madison, Wisconsin
AnWie|Wien Ann                   |Annalen der Universitaets-Sternwarte Wien
MiWie|Wien Mitt                  |Mitteilungen der Universitaets-Sternwarte Wien
     |Wilno Bull                 |Bulletin de l'Observatoire Astronomique de Wilno
     |Wrocl Comm                 |Communications from the Wroclaw Astronomical Observatory
CoWro|Wrocl Contr                |Contributions from the Wroclaw Astronomical Observatory
TOYal|Yale Trans                 |Transactions of the Astronomical Observatory of Yale University
PYerO|Yerkes Publ                |Publications of the Yerkes Observatory
     |Zo-Se Ann                  |Annales de l'Observatoire Astronomique de Zo-Se
ZA   |ZsAp                       |Zeitschrift fuer Astrophysik
